#######
#######
#vvv###
~~~~vv#
#~s~v##
#v~~###
###~###