#######
#######
#vvv###
~~~~vv#
#~~~v##
#v~~###
###~###