#....~#
#.###~#
..#~~~#
.s#~~~#
###~~v#
###~v##
###~###