#....~#
#.###~#
..#~~~#
.s#~~v#
###~~~#
###~v~#
###~###