###.###
###..##
####.##
..##.##
#.##.##
#.s..##
####v##