##v.v##
##v.v##
##v.v##
.....v#
#....v#
#..s.v#
#v>>>##